akesi=a ke si
ala=a la
alasa=a la sa
ale=a le
ali=a li
anpa=an pa
ante=an te
anu=a nu
awen=a wen
epiku=e pi ku
esun=e sun
ete=e te
ewe=e we
ijo=i jo
ike=i ke
ilo=i lo
insa=in sa
isipin=i si pin
jaki=ja ki
jami=ja mi
jasima=ja si ma
jelo=je lo
kala=ka la
kalama=ka la ma
kama=ka ma
kamalawala=ka ma la wa la
kapesi=ka pe si
kasi=ka si
kepeken=ke pe ken
kese=ke se
kijetesantakalu=ki je te san ta ka lu
kiki=ki ki
kili=ki li
kipisi=ki pi si
kiwen=ki wen
kokosila=ko ko si la
kule=ku le
kulijo=ku li jo
kulupu=ku lu pu
kuntu=kun tu
kute=ku te
lanpan=lan pan
lape=la pe
laso=la so
lawa=la wa
leko=le ko
lete=le te
lili=li li
linja=lin ja
linluwi=lin lu wi
lipu=li pu
loje=lo je
luka=lu ka
lukin=lu kin
lupa=lu pa
majuna=ma ju na
mama=ma ma
mani=ma ni
meli=me li
melome=me lo me
meso=me so
mije=mi je
mijomi=mi jo mi
misa=mi sa
misikeke=mi si ke ke
moku=mo ku
moli=mo li
monsi=mon si
monsuta=mon su ta
mulapisu=mu la pi su
musi=mu si
mute=mu te
namako=na ma ko
nanpa=nan pa
nasa=na sa
nasin=na sin
natu=na tu
nena=ne na
nimi=ni mi
noka=no ka
oke=o ke
oko=o ko
olin=o lin
omekapo=o me ka po
ona=o na
open=o pen
pakala=pa ka la
pake=pa ke
pali=pa li
palisa=pa li sa
pana=pa na
pata=pa ta
pilin=pi lin
pimeja=pi me ja
pini=pi ni
pipi=pi pi
poka=po ka
poki=po ki
pona=po na
powe=po we
puwa=pu we
sama=sa ma
seli=se li
seme=se me
sewi=se wi
sijelo=si je lo
sike=si ke
sina=si na
sinpin=sin pin
sitelen=si te len
soko=so ko
sona=so na
soto=so to
soweli=so we li
suli=su li
suno=su no
supa=su pa
sutopatikuna=su to pa ti ku na
suwi=su wi
taki=ta ki
taso=ta so
tawa=ta wa
teje=te je
telo=te lo
tenpo=ten po
toki=to ki
tomo=to mo
tonsi=ton si
tuli=tu si
unpa=un pa
unu=u nu
usawi=u sa wi
uta=u ta
utala=u ta la
waleja=wa le ja
walo=wa lo
waso=wa so
wawa=wa wa
weka=we ka
wekama=we ka ma
wile=wi le
yupekosi=ju pe ko si
a=a
e=e
i=i
o=o
u=u
an=an
en=en
in=in
on=on
un=un
ja=ja
je=je
ji=si
jo=jo
ju=ju
ka=ka
ke=ke
ki=ki
ko=ko
ku=ku
la=la
le=le
li=li
lo=lo
lu=lu
ma=ma
me=me
mi=mi
mo=mo
mu=mu
na=na
ne=ne
ni=ni
no=no
nu=nu
pa=pa
pe=pe
pi=pi
po=po
pu=pu
sa=sa
se=se
si=si
so=so
su=su
ta=ta
te=te
ti=si
to=to
tu=tu
wa=wa
we=we
wi=wi
wo=o
wu=u
jan=jan
kan=kan
lan=lan
man=man
nan=nan
pan=pan
san=san
tan=tan
wan=wan
jen=jen
ken=ken
len=len
men=men
nen=nen
pen=pen
sen=sen
ten=ten
wen=wen
kin=kin
lin=lin
min=min
nin=nin
pin=pin
sin=sin
win=win
jon=jon
kon=kon
lon=lon
mon=mon
non=non
pon=pon
son=son
ton=ton
won=on
jun=jun
kun=kun
lun=lun
mun=mun
nun=nun
pun=pun
sun=sun
tun=tun
wun=un